%sector=iShares Core S&P Small-Cap
TTWO	TAKE-TWO INTERACTIVE SOFTWARE INC.	Information Technology
COHR	COHERENT INC.	Information Technology
TCBI	TEXAS CAPITAL BANCSHARES INC.	Financials
SLCA	US SILICA HOLDINGS INC	Energy
PDCE	PDC ENERGY INC	Energy
WTFC	WINTRUST FINANCIAL CORP.	Financials
MDCO	MEDICINES CO.	Health Care
MASI	MASIMO CORP.	Health Care
UBSI	UNITED BANKSHARES INC.	Financials
MKSI	MKS INSTRUMENTS INC.	Information Technology
BLKB	BLACKBAUD INC.	Information Technology
HOMB	HOME BANCSHARES INC.	Financials
GEO	GEO GROUP REIT INC	Real Estate
STL	STERLING BAN	Financials
ALE	ALLETE INC.	Utilities
PNFP	PINNACLE FINANCIAL PARTNERS INC.	Financials
EVR	EVERCORE PARTNERS INC. CL A	Financials
BGS	B AND G FOODS INC	Consumer Staples
CACI	CACI INTERNATIONAL INC. CL A	Information Technology
MDSO	MEDIDATA SOLUTIONS INC.	Health Care
HCSG	HEALTHCARE SERVICES GROUP INC.	Industrials
CMD	CANTEL MEDICAL CORP	Health Care
SANM	SANMINA CORP.	Information Technology
COR	CORESITE REALTY CORP.	Real Estate
SR	SPIRE INC	Utilities
PRA	PROASSURANCE CORP.	Financials
FFIN	FIRST FINANCIAL BANKSHARES INC.	Financials
CHE	CHEMED CORP.	Health Care
GBCI	GLACIER BANCORP INC.	Financials
LITE	LUMENTUM HOLDINGS INC	Information Technology
HOPE	HOPE BANCORP INC	Financials
AKS	AK STEEL HOLDING CORP.	Materials
HA	HAWAIIAN HOLDINGS INC.	Industrials
LCII	LCI INDUSTRIES	Consumer Discretionary
CBU	COMMUNITY BANK SYSTEM INC.	Financials
BCPC	BALCHEM CORP.	Materials
WAGE	WAGEWORKS INC	Industrials
IART	INTEGRA LIFESCIENCES HOLDINGS CORP	Health Care
IBKR	INTERACTIVE BROKERS GROUP INC.	Financials
SJI	SOUTH JERSEY INDUSTRIES INC.	Utilities
AKR	ACADIA REALTY TRUST REIT	Real Estate
AVA	AVISTA CORP.	Utilities
ONB	OLD NATIONAL BANCORP	Financials
B	BARNES GROUP INC.	Industrials
NEOG	NEOGEN CORP.	Health Care
FUL	H.B. FULLER CO.	Materials
GWB	GREAT WESTERN BANCORP INC	Financials
JBT	JOHN BEAN TECHNOLOGIES CORP.	Industrials
VIAV	VIAVI SOLUTIONS INC	Information Technology
AIT	APPLIED INDUSTRIAL TECHNOLOGIES IN	Industrials
AEIS	ADVANCED ENERGY INDUSTRIES INC.	Information Technology
MLI	MUELLER INDUSTRIES INC.	Industrials
TTEK	TETRA TECH INC.	Industrials
AXE	ANIXTER INTERNATIONAL INC.	Information Technology
TIVO	TIVO CORP	Information Technology
LXP	LEXINGTON REALTY TRUST REIT	Real Estate
COLB	COLUMBIA BANKING SYSTEM INC.	Financials
ASGN	ON ASSIGNMENT INC.	Industrials
CVBF	CVB FINANCIAL CORP.	Financials
BCO	THE BRINKS COMPANY	Industrials
LAD	LITHIA MOTORS INC. CL A	Consumer Discretionary
WWW	WOLVERINE WORLD WIDE INC.	Consumer Discretionary
NGVT	INGEVITY CORP	Materials
HI	HILLENBRAND INC.	Industrials
SMTC	SEMTECH CORP.	Information Technology
PSB	PS BUSINESS PARKS REIT INC	Real Estate
RLI	RLI CORP.	Financials
DRH	DIAMONDROCK HOSPITALITY CO.	Real Estate
ABM	ABM INDUSTRIES INC.	Industrials
ICUI	ICU MEDICAL INC.	Health Care
ALGT	ALLEGIANT TRAVEL CO.	Industrials
EFII	ELECTRONICS FOR IMAGING INC.	Information Technology
MATW	MATTHEWS INTERNATIONAL CORP. CL A	Industrials
FIVE	FIVE BELOW INC	Consumer Discretionary
VAC	MARRIOTT VACATIONS WORLDWIDE CORP.	Consumer Discretionary
MOG.A	MOOG INC. CL A	Industrials
DORM	DORMAN PRODUCTS INC.	Consumer Discretionary
KNX	KNIGHT TRANSPORTATION INC.	Industrials
PLAY	DAVE AND BUSTERS ENTERTAINMENT INC	Consumer Discretionary
ROIC	RETAIL OPPORTUNITY INVESTMENTS COR	Real Estate
UFPI	UNIVERSAL FOREST PRODUCTS INC.	Industrials
FNGN	FINANCIAL ENGINES INC	Financials
TSRA	TESSERA HOLDING CORP	Information Technology
ITRI	ITRON INC.	Information Technology
FCFS	FIRSTCASH INC	Financials
IIVI	II-VI INC.	Information Technology
DAR	DARLING INGREDIENTS INC	Consumer Staples
STMP	STAMPS.COM INC.	Information Technology
UCBI	UNITED COMMUNITY BANKS INC.	Financials
KS	KAPSTONE PAPER & PACKAGING CORP.	Materials
TREX	TREX INC CO	Industrials
SWC	STILLWATER MINING	Materials
CATM	CARDTRONICS PLC CLASS A	Information Technology
CRZO	CARRIZO OIL AND GAS INC	Energy
UNF	UNIFIRST CORP.	Industrials
LGND	LIGAND PHARMACEUTICALS INC.	Health Care
NKTR	NEKTAR THERAPEUTICS	Health Care
ILG	ILG INC	Consumer Discretionary
FMBI	FIRST MIDWEST BANCORP	Financials
ZLTQ	ZELTIQ AESTHETICS INC	Health Care
CPS	COOPER STANDARD HOLDINGS INC	Consumer Discretionary
SHOO	STEVEN MADDEN LTD.	Consumer Discretionary
PRAA	PRA GROUP INC	Financials
HAE	HAEMONETICS CORP.	Health Care
AMN	AMN HEALTHCARE INC	Health Care
JJSF	J&J SNACK FOODS CORP.	Consumer Staples
EGP	EASTGROUP PROPERTIES INC.	Real Estate
KRG	KITE REALTY GROUP TRUST REIT	Real Estate
PLXS	PLEXUS CORP.	Information Technology
POWI	POWER INTEGRATIONS INC.	Information Technology
EE	EL PASO ELECTRIC CO.	Utilities
SAFM	SANDERSON FARMS INC.	Consumer Staples
BRC	BRADY CORP. CL A	Industrials
MNRO	MONRO MUFFLER BRAKE INC.	Consumer Discretionary
NTGR	NETGEAR INC.	Information Technology
GK	G & K SERVICES INC. SHS -A-	Industrials
SKYW	SKYWEST INC.	Industrials
SFBS	SERVISFIRST BANCSHARES INC	Financials
LTC	LTC PROPERTIES INC.	Real Estate
MGLN	MAGELLAN HEALTH INC	Health Care
HQY	HEALTHEQUITY INC	Health Care
NWBI	NORTHWEST BANCSHARES INC.	Financials
MSTR	MICROSTRATEGY INC.	Information Technology
SIGI	SELECTIVE INSURANCE GROUP INC.	Financials
PLCE	CHILDRENS PLACE INC	Consumer Discretionary
SFNC	SIMMONS FIRST NATIONAL CORP CLASS	Financials
SSD	SIMPSON MANUFACTURING CO.	Industrials
NBTB	NBT BANCORP INC.	Financials
FN	FABRINET	Information Technology
KFY	KORN/FERRY INTERNATIONAL	Industrials
LTXB	LEGACYTEXAS FINANCIAL GROUP INC	Financials
FFBC	FIRST FINANCIAL BANCORP (OHIO)	Financials
KWR	QUAKER CHEMICAL CORP.	Materials
MRCY	MERCURY SYSTEMS INC.	Industrials
AAT	AMERICAN ASSETS TRUST REIT INC	Real Estate
CBM	CAMBREX CORP.	Health Care
WTS	WATTS WATER TECHNOLOGIES INC. CL A	Industrials
SYRG	SYNERGY RESOURCES CORP	Energy
INDB	INDEPENDENT BANK CORP.	Financials
AF	ASTORIA FINANCIAL CORP.	Financials
CCOI	COGENT COMMUNICATIONS HOLDINGS INC	Telecommunications
HW	HEADWATERS INC.	Materials
BOFI	BOFI HOLDING INC.	Financials
ABCB	AMERIS BANCORP	Financials
IOSP	INNOSPEC INC.	Materials
AEL	AMERICAN EQUITY INVESTMENT LIFE HO	Financials
UVV	UNIVERSAL CORP.	Consumer Staples
NWN	NORTHWEST NATURAL GAS CO.	Utilities
HMN	HORACE MANN EDUCATORS CORP.	Financials
CWT	CALIFORNIA WATER SERVICE GROUP	Utilities
APOG	APOGEE ENTERPRISES INC.	Industrials
BYD	BOYD GAMING CORP.	Consumer Discretionary
HUBG	HUB GROUP INC. CL A	Industrials
CCMP	CABOT MICROELECTRONICS CORP.	Information Technology
SBRA	SABRA HEALTHCARE REIT INC.	Real Estate
AWR	AMERICAN STATES WATER CO.	Utilities
SFLY	SHUTTERFLY INC.	Consumer Discretionary
PFS	PROVIDENT FINANCIAL SERVICES INC.	Financials
BHE	BENCHMARK ELECTRONICS INC.	Information Technology
GPI	GROUP 1 AUTOMOTIVE INC.	Consumer Discretionary
NSP	INSPERITY INC.	Industrials
EXLS	EXLSERVICE HOLDINGS INC.	Information Technology
HMSY	HMS HOLDINGS CORP.	Health Care
ATU	ACTUANT CORP. CL A	Industrials
NSIT	INSIGHT ENTERPRISES INC.	Information Technology
SCAI	SURGICAL CARE AFFILIATES INC	Health Care
CYNO	CYNOSURE INC. CL A	Health Care
WDFC	WD-40 CO.	Consumer Staples
FELE	FRANKLIN ELECTRIC CO. INC.	Industrials
MEI	METHODE ELECTRONICS INC.	Information Technology
MATX	MATSON INC.	Industrials
AXL	AMERICAN AXLE & MANUFACTURING HOLD	Consumer Discretionary
BANR	BANNER CORP.	Financials
OLLI	OLLIES BARGAIN OUTLET HOLDINGS INC	Consumer Discretionary
CHSP	CHESAPEAKE LODGING TRUST REIT	Real Estate
AZZ	AZZ INC.	Industrials
SCL	STEPAN CO.	Materials
FWRD	FORWARD AIR CORP.	Industrials
CORE	CORE-MARK HOLDING CO. INC.	Consumer Discretionary
EXPO	EXPONENT INC.	Industrials
IRBT	IROBOT CORP.	Consumer Discretionary
WABC	WESTAMERICA BANCORP	Financials
MINI	MOBILE MINI INC.	Industrials
BRKS	BROOKS AUTOMATION INC.	Information Technology
KALU	KAISER ALUMINUM CORP.	Materials
SPTN	SPARTANNASH	Consumer Staples
KLIC	KULICKE AND SOFFA INDUSTRIES INC	Information Technology
BLD	TOPBUILD CORP	Consumer Discretionary
PRGS	PROGRESS SOFTWARE CORP.	Information Technology
LZB	LA-Z-BOY INC	Consumer Discretionary
FLOW	SPX FLOW INC	Industrials
ESE	ESCO TECHNOLOGIES INC.	Industrials
ROG	ROGERS CORP.	Information Technology
BPFH	BOSTON PRIVATE FINANCIAL HOLDINGS	Financials
KAMN	KAMAN CORP.	Industrials
OMCL	OMNICELL INC.	Health Care
OSIS	OSI SYSTEMS INC.	Information Technology
TTMI	TTM TECHNOLOGIES INC.	Information Technology
SNCR	SYNCHRONOSS TECHNOLOGIES INC.	Information Technology
RMBS	RAMBUS INC.	Information Technology
PLKI	POPEYES LOUISIANA KITCHEN INC	Consumer Discretionary
AIN	ALBANY INTERNATIONAL CORP. CL A	Industrials
TASR	TASER INTERNATIONAL INC.	Industrials
SEM	SELECT MEDICAL HOLDINGS CORPORATIO	Health Care
INN	SUMMIT HOTEL PROPERTIES INC.	Real Estate
AJRD	AEROJET ROCKETDYNE HOLDINGS INC	Industrials
EGOV	NIC INC.	Information Technology
NPO	ENPRO INDUSTRIES INC.	Industrials
AAON	AAON INC.	Industrials
PRLB	PROTO LABS INC	Industrials
EGHT	8X8 INC.	Information Technology
AAWW	ATLAS AIR WORLDWIDE HOLDINGS	Industrials
ASTE	ASTEC INDUSTRIES INC	Industrials
ABG	ASBURY AUTOMOTIVE GROUP INC.	Consumer Discretionary
AMED	AMEDISYS INC.	Health Care
UNT	UNIT CORP.	Energy
CAL	CALERES INC	Consumer Discretionary
EBIX	EBIX INC.	Information Technology
TGI	TRIUMPH GROUP INC.	Industrials
FSP	FRANKLIN STREET PROPERTIES REIT CO	Real Estate
CUB	CUBIC CORP.	Industrials
CNSL	CONSOLIDATED COMMUNICATIONS HOLDIN	Telecommunications
THRM	GENTHERM INC	Consumer Discretionary
FCPT	FOUR CORNERS PROPERTY INC TRUST	Real Estate
STBA	S&T BANCORP INC.	Financials
AIRM	AIR METHODS CORP.	Health Care
MTH	MERITAGE HOMES CORP.	Consumer Discretionary
CSGS	CSG SYSTEMS INTERNATIONAL INC.	Information Technology
MYGN	MYRIAD GENETICS INC.	Health Care
FCF	FIRST COMMONWEALTH FINANCIAL CORP.	Financials
SUPN	SUPERNUS PHARMACEUTICALS INC	Health Care
SWM	SCHWEITZER-MAUDUIT INTERNATIONAL I	Materials
ADC	AGREE REALTY CORP.	Real Estate
NP	NEENAH PAPER INC.	Materials
WNC	WABASH NATIONAL CORP.	Industrials
GBX	GREENBRIER INC	Industrials
SCHL	SCHOLASTIC CORP.	Consumer Discretionary
ROCK	GIBRALTAR INDUSTRIES INC.	Industrials
BABY	NATUS MEDICAL INC.	Health Care
TNC	TENNANT CO.	Industrials
MMSI	MERIT MEDICAL SYSTEMS INC.	Health Care
AMSF	AMERISAFE INC.	Financials
GCO	GENESCO INC.	Consumer Discretionary
FIX	COMFORT SYSTEMS USA INC.	Industrials
NAVG	NAVIGATORS GROUP INC.	Financials
RRD	RR DONNELLEY AND SONS	Industrials
VREX	VAREX IMAGING CORP	Health Care
SXI	STANDEX INTERNATIONAL CORP.	Industrials
XXIA	IXIA	Information Technology
SONC	SONIC CORP.	Consumer Discretionary
MNTA	MOMENTA PHARMACEUTICALS INC.	Health Care
SAIA	SAIA INC.	Industrials
EIG	EMPLOYERS HOLDINGS INC.	Financials
SSP	E.W. SCRIPPS CO. CL A	Consumer Discretionary
BEL	BELMOND LTD CLASS A	Consumer Discretionary
GDOT	GREEN DOT CORP. CL A	Financials
GTLS	CHART INDUSTRIES INC.	Industrials
PEI	PENNSYLVANIA REAL ESTATE INVESTMEN	Real Estate
ACOR	ACORDA THERAPEUTICS INC.	Health Care
MDC	M.D.C. HOLDINGS INC.	Consumer Discretionary
GIII	G III APPAREL GROUP LTD	Consumer Discretionary
CALM	CAL-MAINE FOODS INC.	Consumer Staples
TILE	INTERFACE INC.	Industrials
SYKE	SYKES ENTERPRISES INC.	Information Technology
PATK	PATRICK INDUSTRIES INC	Industrials
CENTA	CENTRAL GARDEN & PET CO. CL A	Consumer Staples
BRKL	BROOKLINE BANCORP INC.	Financials
ABAX	ABAXIS INC.	Health Care
BOBE	BOB EVANS FARMS INC.	Consumer Discretionary
CKH	SEACOR HOLDINGS INC.	Energy
HSC	HARSCO CORP.	Industrials
ECOL	US ECOLOGY INC.	Industrials
WD	WALKER & DUNLOP INC.	Financials
INGN	INOGEN INC	Health Care
VECO	VEECO INSTRUMENTS INC.	Information Technology
TMP	TOMPKINS FINANCIAL CORP	Financials
MHLD	MAIDEN HOLDINGS LTD.	Financials
TBI	TRUEBLUE INC.	Industrials
TLRD	TAILORED BRANDS INC	Consumer Discretionary
AROC	ARCHROCK INC	Energy
HAFC	HANMI FINANCIAL CORP.	Financials
NCI	NAVIGANT CONSULTING INC.	Industrials
AIR	AAR CORP.	Industrials
PJC	PIPER JAFFRAY COS.	Financials
SCSC	SCANSOURCE INC.	Information Technology
HF	HFF INC. CL A	Real Estate
IPXL	IMPAX LABORATORIES INC.	Health Care
CNMD	CONMED CORP.	Health Care
AMWD	AMERICAN WOODMARK CORP.	Industrials
NTRI	NUTRISYSTEM INC.	Consumer Discretionary
RAVN	RAVEN INDUSTRIES INC.	Industrials
RMAX	RE MAX HOLDINGS INC CLASS A	Real Estate
BCC	BOISE CASCADE COMPANY	Materials
ADTN	ADTRAN INC.	Information Technology
STC	STEWART INFORMATION SERVICES CORP.	Financials
EBS	EMERGENT BIOSOLUTIONS INC.	Health Care
UEIC	UNIVERSAL ELECTRONICS INC.	Consumer Discretionary
ANDE	ANDERSONS INC.	Consumer Staples
SSTK	SHUTTERSTOCK INC	Information Technology
BMI	BADGER METER INC.	Information Technology
SVU	SUPERVALU INC	Consumer Staples
RGEN	REPLIGEN CORP.	Health Care
SPXC	SPX CORP	Industrials
RH	RH	Consumer Discretionary
TISI	TEAM INC	Industrials
SCSS	SELECT COMFORT CORP.	Consumer Discretionary
SGMS	SCIENTIFIC GAMES CORP.	Consumer Discretionary
GCI	GANNETT INC	Consumer Discretionary
MANT	MANTECH INTERNATIONAL CORP CLASS A	Information Technology
CFNL	CARDINAL FINANCIAL CORP.	Financials
QLYS	QUALYS INC	Information Technology
GLT	GLATFELTER	Materials
ALOG	ANALOGIC CORP.	Health Care
DIN	DINEEQUITY INC.	Consumer Discretionary
LDL	LYDALL INC.	Industrials
FBP	FIRST BANCORP (PUERTO RICO)	Financials
DEPO	DEPOMED INC.	Health Care
SMCI	SUPER MICRO COMPUTER INC.	Information Technology
CMO	CAPSTEAD MORTGAGE CORP.	Financials
CIR	CIRCOR INTERNATIONAL INC.	Industrials
WIRE	ENCORE WIRE CORP.	Industrials
EXTN	EXTERRAN CORP	Energy
CHCO	CITY HOLDING CO.	Financials
SHLM	A. SCHULMAN INC.	Materials
DIOD	DIODES INC.	Information Technology
CUBI	CUSTOMERS BANCORP INC	Financials
IPCC	INFINITY PROPERTY & CASUALTY CORP.	Financials
VASC	VASCULAR SOLUTIONS INC.	Health Care
CTRE	CARETRUST REIT INC	Real Estate
CPF	CENTRAL PACIFIC FINANCIAL CORP.	Financials
BANC	BANC OF CALIFORNIA INC	Financials
SMP	STANDARD MOTOR PRODUCTS INC.	Consumer Discretionary
ITGR	INTEGER HOLDINGS CORP	Health Care
HLX	HELIX ENERGY SOLUTIONS GROUP INC.	Energy
ELY	CALLAWAY GOLF CO.	Consumer Discretionary
CLW	CLEARWATER PAPER CORP.	Materials
IPHS	INNOPHOS HOLDINGS INC	Materials
CVCO	CAVCO INDUSTRIES INC.	Consumer Discretionary
VVI	VIAD CORP.	Industrials
LABL	MULTI-COLOR CORP.	Industrials
RGR	STURM RUGER INC CO	Consumer Discretionary
MTSC	MTS SYSTEMS CORP.	Information Technology
SBSI	SOUTHSIDE BANCSHARES INC.	Financials
BGG	BRIGGS & STRATTON CORP.	Industrials
EPAY	BOTTOMLINE TECHNOLOGIES INC.	Information Technology
INVA	INNOVIVA INC	Health Care
SPSC	SPS COMMERCE INC.	Information Technology
PKY	PARKWAY INC	Real Estate
USPH	U.S. PHYSICAL THERAPY INC.	Health Care
FSS	FEDERAL SIGNAL CORP.	Industrials
EXPR	EXPRESS INC	Consumer Discretionary
TYPE	MONOTYPE IMAGING HOLDINGS INC.	Information Technology
WGO	WINNEBAGO INDUSTRIES INC.	Consumer Discretionary
CVGW	CALAVO GROWERS INC.	Consumer Staples
USCR	U.S. CONCRETE INC.	Materials
ASIX	ADVANSIX INC	Materials
CPLA	CAPELLA EDUCATION CO.	Consumer Discretionary
KOP	KOPPERS HOLDINGS INC.	Materials
HTLD	HEARTLAND EXPRESS INC.	Industrials
TVTY	TIVITY HEALTH INC	Health Care
ENSG	ENSIGN GROUP INC.	Health Care
ATNI	ATN INTERNATIONAL INC	Telecommunications
ASNA	ASCENA RETAIL GROUP INC.	Consumer Discretionary
NBHC	NATIONAL BANK HOLDINGS CORPORATION	Financials
GPRE	GREEN PLAINS INC	Energy
WWE	WORLD WRESTLING ENTERTAINMENT INC	Consumer Discretionary
UVE	UNIVERSAL INSURANCE HOLDINGS INC	Financials
OXM	OXFORD INDUSTRIES INC.	Consumer Discretionary
MDXG	MIMEDX GROUP INC	Health Care
CBB	CINCINNATI BELL INC	Telecommunications
KRA	KRATON CORP	Materials
NEWM	NEW MEDIA INVESTMENT GROUP INC	Consumer Discretionary
LNN	LINDSAY CORP.	Industrials
ANF	ABERCROMBIE & FITCH CO. CL A	Consumer Discretionary
NFBK	NORTHFIELD BANCORP INC.	Financials
AMAG	AMAG PHARMACEUTICALS INC.	Health Care
STRA	STRAYER EDUCATION INC.	Consumer Discretionary
GOV	GOVERNMENT PROPERTIES INCOME TRUST	Real Estate
PMC	PHARMERICA CORP.	Health Care
IBP	INSTALLED BUILDING PRODUCTS INC	Consumer Discretionary
WING	WINGSTOP INC	Consumer Discretionary
GHL	GREENHILL & CO.	Financials
CCC	CALGON CARBON CORP.	Materials
TREE	LENDINGTREE INC	Financials
DEL	DELTIC TIMBER CORP.	Materials
TRST	TRUSTCO BANK CORP.	Financials
PLUS	EPLUS INC.	Information Technology
GES	GUESS? INC.	Consumer Discretionary
BGC	GENERAL CABLE CORP.	Industrials
ESND	ESSENDANT INC	Industrials
VRTU	VIRTUSA CORP	Information Technology
BFS	SAUL CENTERS INC.	Real Estate
CYH	COMMUNITY HEALTH SYSTEMS INC.	Health Care
UFCS	UNITED FIRE GROUP INC	Financials
AEGN	AEGION CORP	Industrials
CTS	CTS CORP.	Information Technology
FOXF	FOX FACTORY HOLDING CORP	Consumer Discretionary
IRDM	IRIDIUM COMMUNICATIONS INC.	Telecommunications
TMST	TIMKENSTEEL CORP	Materials
SAFT	SAFETY INSURANCE GROUP INC.	Financials
FRGI	FIESTA RESTAURANT GROUP INC.	Consumer Discretionary
GFF	GRIFFON CORP.	Industrials
CEVA	CEVA INC.	Information Technology
CENX	CENTURY ALUMINUM CO.	Materials
ARCB	ARCBEST CORP	Industrials
PGNX	PROGENICS PHARMACEUTICALS INC.	Health Care
LMNX	LUMINEX CORP	Health Care
ATW	ATWOOD OCEANICS INC.	Energy
LHCG	LHC GROUP	Health Care
ALG	ALAMO GROUP INC.	Industrials
LKSD	LSC COMMUNICATIONS INC	Industrials
VRTS	VIRTUS INVESTMENT PARTNERS INC.	Financials
QSII	QUALITY SYSTEMS INC.	Health Care
BJRI	BJS RESTAURANTS INC.	Consumer Discretionary
ANIK	ANIKA THERAPEUTICS INC.	Health Care
MTRN	MATERION CORP.	Materials
ETH	ETHAN ALLEN INTERIORS INC.	Consumer Discretionary
FINL	FINISH LINE INC. CL A	Consumer Discretionary
GTY	GETTY REALTY CORP.	Real Estate
BEAT	BIOTELEMETRY INC	Health Care
FRAN	FRANCESCAS HOLDINGS CORP	Consumer Discretionary
NANO	NANOMETRICS INC.	Information Technology
DCOM	DIME COMMUNITY BANCSHARES	Financials
RTEC	RUDOLPH TECHNOLOGIES INC	Information Technology
NX	QUANEX BUILDING PRODUCTS CORP.	Industrials
CATO	CATO CORP. CL A	Consumer Discretionary
HIBB	HIBBETT SPORTS INC.	Consumer Discretionary
HMST	HOMESTREET INC.	Financials
UTEK	ULTRATECH INC.	Information Technology
SHAK	SHAKE SHACK INC CLASS A	Consumer Discretionary
LCI	LANNETT COMPANY INC	Health Care
ORIT	ORITANI FINANCIAL CORP.	Financials
PRFT	PERFICIENT INC.	Information Technology
FTK	FLOTEK INDUSTRIES INC.	Materials
AMPH	AMPHASTAR PHARMACEUTICALS INC	Health Care
KELYA	KELLY SERVICES INC. CL A	Industrials
DFIN	DONNELLEY FINANCIAL SOLUTIONS INC	Financials
ECPG	ENCORE CAPITAL GROUP INC.	Financials
SXC	SUNCOKE ENERGY INC.	Materials
ECHO	ECHO GLOBAL LOGISTICS INC	Industrials
IIIN	INSTEEL INDUSTRIES INC.	Industrials
FARO	FARO TECHNOLOGIES INC.	Information Technology
NR	NEWPARK RESOURCES INC.	Energy
MYRG	MYR GROUP INC.	Industrials
DPLO	DIPLOMAT PHARMACY INC	Health Care
SAH	SONIC AUTOMOTIVE INC. CL A	Consumer Discretionary
RRGB	RED ROBIN GOURMET BURGERS INC.	Consumer Discretionary
KND	KINDRED HEALTHCARE INC.	Health Care
IPAR	INTER PARFUMS INC.	Consumer Staples
CECO	CAREER EDUCATION CORP.	Consumer Discretionary
BCOR	BLUCORA INC	Information Technology
OFG	OFG BANCORP.	Financials
TWI	TITAN INTERNATIONAL INC	Industrials
HSTM	HEALTHSTREAM INC.	Health Care
BKE	BUCKLE INC.	Consumer Discretionary
MHO	M/I HOMES INC.	Consumer Discretionary
BKS	BARNES & NOBLE INC.	Consumer Discretionary
TTS	TILE SHOP HOLDINGS INC	Consumer Discretionary
MCS	MARCUS CORP.	Consumer Discretionary
EGRX	EAGLE PHARMACEUTICALS INC	Health Care
TG	TREDEGAR CORP.	Materials
FRED	FREDS INC.	Consumer Discretionary
DXPE	DXP ENTERPRISES INC.	Industrials
PGTI	PGT INNOVATIONS INC	Industrials
CAMP	CALAMP CORP.	Information Technology
HZO	MARINEMAX INC	Consumer Discretionary
RYAM	RAYONIER ADVANCED MATERIALS INC	Materials
NPK	NATIONAL PRESTO INDUSTRIES INC.	Industrials
INTL	INTL FCSTONE INC.	Financials
AVAV	AEROVIRONMENT INC.	Industrials
EGL	ENGILITY HOLDINGS INC	Industrials
MRTN	MARTEN TRANSPORT LTD.	Industrials
AFAM	ALMOST FAMILY INC.	Health Care
PAHC	PHIBRO ANIMAL HEALTH CORP CLASS A	Health Care
MPAA	MOTORCAR PARTS OF AMERICA INC.	Consumer Discretionary
BRS	BRISTOW GROUP INC.	Energy
VIVO	MERIDIAN BIOSCIENCE INC.	Health Care
NLS	NAUTILUS INC.	Consumer Discretionary
TTI	TETRA TECHNOLOGIES INC.	Energy
SUP	SUPERIOR INDUSTRIES INTERNATIONAL	Consumer Discretionary
HAYN	HAYNES INTERNATIONAL INC.	Materials
GNCMA	GENERAL COMMUNICATION INC. CL A	Telecommunications
ICON	ICONIX BRAND GROUP INC.	Consumer Discretionary
VSI	VITAMIN SHOPPE INC.	Consumer Discretionary
RUTH	RUTHS HOSPITALITY GROUP INC.	Consumer Discretionary
VRTV	VERITIV CORP	Industrials
CCRN	CROSS COUNTRY HEALTHCARE INC.	Health Care
ANGO	ANGIODYNAMICS INC.	Health Care
ANIP	ANI PHARMACEUTICALS INC	Health Care
LION	FIDELITY SOUTHERN CORP.	Financials
CHUY	CHUYS HOLDINGS INC	Consumer Discretionary
CROX	CROCS INC.	Consumer Discretionary
RECN	RESOURCES CONNECTION INC.	Industrials
MED	MEDIFAST INC.	Consumer Staples
LDR	LANDAUER INC.	Health Care
PRSC	PROVIDENCE SERVICE CORP	Health Care
SCLN	SCICLONE PHARMACEUTICALS INC.	Health Care
LGIH	LGI HOMES INC	Consumer Discretionary
NILE	BLUE NILE INC.	Consumer Discretionary
ACET	ACETO CORP.	Health Care
EXAR	EXAR CORP	Information Technology
HWKN	HAWKINS INC.	Materials
TTEC	TELETECH HOLDINGS INC.	Information Technology
REX	REX AMERICAN RESOURCES CORP.	Energy
UHT	UNIVERSAL HEALTH REALTY INCOME TRU	Real Estate
XOXO	XO GROUP INC.	Information Technology
CRY	CRYOLIFE INC.	Health Care
UBA	URSTADT BIDDLE PROPERTIES REIT CLA	Real Estate
MTRX	MATRIX SERVICE CO.	Energy
BH	BIGLARI HOLDINGS INC.	Consumer Discretionary
ITG	INVESTMENT TECHNOLOGY GROUP INC.	Financials
EZPW	EZCORP INC. CL A	Financials
RGS	REGIS CORP.	Consumer Discretionary
HLIT	HARMONIC INC.	Information Technology
PES	PIONEER ENERGY SERVICES CORP	Energy
RCII	RENT-A-CENTER INC.	Consumer Discretionary
BBG	BILL BARRETT CORP.	Energy
PETS	PETMED EXPRESS INC.	Consumer Discretionary
HVT	HAVERTY FURNITURE COS. INC.	Consumer Discretionary
UFI	UNIFI INC.	Consumer Discretionary
AVD	AMERICAN VANGUARD CORP.	Materials
BKMU	BANK MUTUAL CORP.	Financials
LL	LUMBER LIQUIDATORS HOLDINGS INC.	Consumer Discretionary
FTD	FTD COMPANIES INC	Consumer Discretionary
CRVL	CORVEL CORP.	Health Care
DAKT	DAKTRONICS INC.	Information Technology
HSII	HEIDRICK & STRUGGLES INTERNATIONAL	Industrials
AMRI	ALBANY MOLECULAR RESEARCH INC.	Health Care
VDSI	VASCO DATA SECURITY INTERNATIONAL	Information Technology
CDR	CEDAR REALTY TRUST INC	Real Estate
COHU	COHU INC.	Information Technology
ENTA	ENANTA PHARMACEUTICALS INC	Health Care
TESO	TESCO CORP	Energy
BNED	BARNES AND NOBLE EDUCATION INC	Consumer Discretionary
OPB	OPUS BANK	Financials
MOV	MOVADO GROUP INC.	Consumer Discretionary
SPPI	SPECTRUM PHARMACEUTICALS INC.	Health Care
APEI	AMERICAN PUBLIC EDUCATION INC	Consumer Discretionary
FORR	FORRESTER RESEARCH INC.	Information Technology
IVC	INVACARE CORP.	Health Care
SPOK	SPOK HOLDINGS INC	Telecommunications
LPSN	LIVEPERSON INC	Information Technology
LMOS	LUMOS NETWORKS CORP	Telecommunications
PKE	PARK ELECTROCHEMICAL CORP.	Information Technology
ZUMZ	ZUMIEZ INC.	Consumer Discretionary
CLD	CLOUD PEAK ENERGY INC.	Energy
CENT	CENTRAL GARDEN & PET CO.	Consumer Staples
ENVA	ENOVA INTERNATIONAL INC	Financials
DGII	DIGI INTERNATIONAL INC.	Information Technology
SRDX	SURMODICS INC.	Health Care
SCVL	SHOE CARNIVAL INC.	Consumer Discretionary
FOR	FORESTAR GROUP INC.	Real Estate
HCI	HCI GROUP INC	Financials
WRLD	WORLD ACCEPTANCE CORP.	Financials
MYE	MYERS INDUSTRIES INC.	Materials
CRR	CARBO CERAMICS INC.	Energy
FF	FUTUREFUEL CORP.	Materials
POWL	POWELL INDUSTRIES INC.	Industrials
LOCO	EL POLLO LOCO INC	Consumer Discretionary
ERA	ERA GROUP INC.	Energy
CPSI	COMPUTER PROGRAMS & SYSTEMS INC.	Health Care
ORN	ORION GROUP INC	Industrials
PERY	PERRY ELLIS INTERNATIONAL INC.	Consumer Discretionary
CMTL	COMTECH TELECOMMUNICATIONS CORP.	Information Technology
DHX	DHI GROUP INC	Information Technology
BELFB	BEL FUSE INC. CL B	Information Technology
MCRI	MONARCH CASINO & RESORT INC.	Consumer Discretionary
UIHC	UNITED INSURANCE HOLDINGS CORP.	Financials
GEOS	GEOSPACE TECHNOLOGIES CORP	Energy
CGI	CELADON GROUP INC.	Industrials
QHC	QUORUM HEALTH CORP	Health Care
VICR	VICOR CORP.	Industrials
BGFV	BIG 5 SPORTING GOODS CORP.	Consumer Discretionary
ACAT	ARCTIC CAT INC.	Consumer Discretionary
SENEA	SENECA FOODS CORP. CL A	Consumer Staples
ESIO	ELECTRO SCIENTIFIC INDUSTRIES INC.	Information Technology
ZEUS	OLYMPIC STEEL INC.	Materials
DSPG	DSP GROUP INC.	Information Technology
RRTS	ROADRUNNER TRANSPORTATION SYSTEMS	Industrials
KOPN	KOPIN CORP.	Information Technology
VRA	VERA BRADLEY INC.	Consumer Discretionary
LQDT	LIQUIDITY SERVICES INC.	Information Technology
MCF	CONTANGO OIL AND GAS	Energy
LXU	LSB INDUSTRIES INC.	Materials
GIFI	GULF ISLAND FABRICATION INC.	Energy
EHTH	EHEALTH INC.	Financials
TUES	TUESDAY MORNING CORP.	Consumer Discretionary
KIRK	KIRKLANDS INC.	Consumer Discretionary
AGYS	AGILYSYS INC.	Information Technology
TNGO	TANGOE INC.	Information Technology
BBOX	BLACK BOX CORP.	Information Technology
NOG	NORTHERN OIL AND GAS INC	Energy
CLMS	CALAMOS ASSET MANAGEMENT INC. SHS	Financials
HT	HERSHA HOSPITALITY TRUST CLASS A	Real Estate
CDI	CDI CORP.	Industrials
RT	RUBY TUESDAY INC.	Consumer Discretionary
QNST	QUINSTREET INC.	Information Technology
SMRT	STEIN MART INC.	Consumer Discretionary
HOS	HORNBECK OFFSHORE SERVICES INC.	Energy
ADPT	ADEPTUS HEALTH INC CLASS A	Health Care
FNBC	FIRST NBC BANK HOLDING	Financials
TDW	TIDEWATER INC.	Energy
CRAY	CRAY INC.	Information Technology
GRB	GERBER SCIENTIFIC ESCROW	Information Technology
