%sector=rank123
IPG	NYSE	Advertising and Marketing
BA	NYSE	Aerospace - Defense
ERJ	NYSE	Aerospace - Defense
GD	NYSE	Aerospace - Defense
LDOS	NYSE	Aerospace - Defense
LMT	NYSE	Aerospace - Defense
NOC	NYSE	Aerospace - Defense
TXT	NYSE	Aerospace - Defense
AOBC	NSDQ	Aerospace - Defense Equipment
COL	NYSE	Aerospace - Defense Equipment
KLXI	NSDQ	Aerospace - Defense Equipment
RTN	NYSE	Aerospace - Defense Equipment
SPR	NYSE	Aerospace - Defense Equipment
TGI	NYSE	Aerospace - Defense Equipment
ADM	NYSE	Agriculture - Operations
AGRO	NYSE	Agriculture - Operations
BG	NYSE	Agriculture - Products
CZZ	NYSE	Agriculture - Products
MON	NYSE	Agriculture - Products
BID	NYSE	Auction and Valuation Services
CPRT	NSDQ	Auction and Valuation Services
RBA	NYSE	Auction and Valuation Services
DLB	NYSE	Audio Video Production
SNE	NYSE	Audio Video Production
F	NYSE	Automotive - Domestic
GM	NYSE	Automotive - Domestic
HOG	NYSE	Automotive - Domestic
PCAR	NSDQ	Automotive - Domestic
CNHI	NYSE	Automotive - Foreign
FCAU	NYSE	Automotive - Foreign
TTM	NYSE	Automotive - Foreign
CMI	NYSE	Automotive - Internal Combustion Engines
ALSN	NYSE	Automotive - Original Equipment
AXL	NYSE	Automotive - Original Equipment
BWA	NYSE	Automotive - Original Equipment
DAN	NYSE	Automotive - Original Equipment
DLPH	NYSE	Automotive - Original Equipment
GNTX	NSDQ	Automotive - Original Equipment
LEA	NYSE	Automotive - Original Equipment
OSK	NYSE	Automotive - Original Equipment
RACE	NYSE	Automotive - Original Equipment
TEN	NYSE	Automotive - Original Equipment
VC	NYSE	Automotive - Original Equipment
WBC	NYSE	Automotive - Original Equipment
WNC	NYSE	Automotive - Original Equipment
GPC	NYSE	Automotive - Replacement Parts
LKQ	NSDQ	Automotive - Replacement Parts
ORLY	NSDQ	Automotive - Retail and Wholesale - Parts
AN	NYSE	Automotive - Retail and Whole Sales
LAD	NYSE	Automotive - Retail and Whole Sales
PAG	NYSE	Automotive - Retail and Whole Sales
BBD	NYSE	Banks - Foreign
BBVA	NYSE	Banks - Foreign
BCS	NYSE	Banks - Foreign
BSAC	NYSE	Banks - Foreign
BSBR	NYSE	Banks - Foreign
BSMX	NYSE	Banks - Foreign
CM	NYSE	Banks - Foreign
HSBC	NYSE	Banks - Foreign
IBN	NYSE	Banks - Foreign
ITUB	NYSE	Banks - Foreign
MTU	NYSE	Banks - Foreign
RBS	NYSE	Banks - Foreign
SAN	NYSE	Banks - Foreign
SMFG	NYSE	Banks - Foreign
BAC	NYSE	Banks - Major Regional
BBT	NYSE	Banks - Major Regional
BK	NYSE	Banks - Major Regional
BKU	NYSE	Banks - Major Regional
CMA	NYSE	Banks - Major Regional
C	NYSE	Banks - Major Regional
FITB	NSDQ	Banks - Major Regional
JPM	NYSE	Banks - Major Regional
KEY	NYSE	Banks - Major Regional
MTB	NYSE	Banks - Major Regional
NTRS	NSDQ	Banks - Major Regional
PNC	NYSE	Banks - Major Regional
STI	NYSE	Banks - Major Regional
STT	NYSE	Banks - Major Regional
USB	NYSE	Banks - Major Regional
WFC	NYSE	Banks - Major Regional
ASB	NYSE	Banks - Midwest
CBSH	NSDQ	Banks - Midwest
FMBI	NSDQ	Banks - Midwest
HBAN	NSDQ	Banks - Midwest
ONB	NSDQ	Banks - Midwest
PVTB	NSDQ	Banks - Midwest
TCB	NYSE	Banks - Midwest
WTFC	NSDQ	Banks - Midwest
BPFH	NSDQ	Banks - Northeast
CBU	NYSE	Banks - Northeast
FCF	NYSE	Banks - Northeast
FULT	NSDQ	Banks - Northeast
MBFI	NSDQ	Banks - Northeast
SBNY	NSDQ	Banks - Northeast
STL	NYSE	Banks - Northeast
UCBI	NSDQ	Banks - Northeast
VLY	NYSE	Banks - Northeast
WAFD	NSDQ	Banks - Northeast
WBS	NYSE	Banks - Northeast
BPOP	NSDQ	Banks - Southeast
BXS	NYSE	Banks - Southeast
FBP	NYSE	Banks - Southeast
FHN	NYSE	Banks - Southeast
HBHC	NSDQ	Banks - Southeast
HOMB	NSDQ	Banks - Southeast
HTH	NYSE	Banks - Southeast
IBKC	NSDQ	Banks - Southeast
OZRK	NSDQ	Banks - Southeast
PSTB	NSDQ	Banks - Southeast
RF	NYSE	Banks - Southeast
SBCF	NSDQ	Banks - Southeast
SNV	NYSE	Banks - Southeast
TRMK	NSDQ	Banks - Southeast
UBSI	NSDQ	Banks - Southeast
CFR	NYSE	Banks - Southwest
PB	NYSE	Banks - Southwest
TCBI	NSDQ	Banks - Southwest
CATY	NSDQ	Banks - West
CUNB	NSDQ	Banks - West
CVBF	NSDQ	Banks - West
EWBC	NSDQ	Banks - West
FHB	NSDQ	Banks - West
FRC	NYSE	Banks - West
GBCI	NSDQ	Banks - West
PACW	NSDQ	Banks - West
SIVB	NSDQ	Banks - West
WAL	NYSE	Banks - West
ZION	NSDQ	Banks - West
ABEV	NYSE	Beverages - Alcohol
BF.B	NYSE	Beverages - Alcohol
BUD	NYSE	Beverages - Alcohol
STZ	NYSE	Beverages - Alcohol
TAP	NYSE	Beverages - Alcohol
CCE	NYSE	Beverages - Soft drinks
COT	NYSE	Beverages - Soft drinks
DPS	NYSE	Beverages - Soft drinks
FMX	NYSE	Beverages - Soft drinks
KO	NYSE	Beverages - Soft drinks
MNST	NSDQ	Beverages - Soft drinks
PEP	NYSE	Beverages - Soft drinks
AMCX	NSDQ	Broadcast Radio and Television
CBS	NYSE	Broadcast Radio and Television
FWONK	NSDQ	Broadcast Radio and Television
GTN	NYSE	Broadcast Radio and Television
NFLX	NSDQ	Broadcast Radio and Television
NXST	NSDQ	Broadcast Radio and Television
SNI	NSDQ	Broadcast Radio and Television
TGNA	NYSE	Broadcast Radio and Television
TRCO	NYSE	Broadcast Radio and Television
LII	NYSE	Building Products - Air Conditioner and Heating
WSO	NYSE	Building Products - Air Conditioner and Heating
CX	NYSE	Building Products - Concrete and Aggregates
EXP	NYSE	Building Products - Concrete and Aggregates
MLM	NYSE	Building Products - Concrete and Aggregates
VMC	NYSE	Building Products - Concrete and Aggregates
DY	NYSE	Building Products - Heavy Construction
EME	NYSE	Building Products - Heavy Construction
MTZ	NYSE	Building Products - Heavy Construction
TPC	NYSE	Building Products - Heavy Construction
BZH	NYSE	Building Products - Home Builders
CAA	NYSE	Building Products - Home Builders
DHI	NYSE	Building Products - Home Builders
KBH	NYSE	Building Products - Home Builders
LEN	NYSE	Building Products - Home Builders
MDC	NYSE	Building Products - Home Builders
MHO	NYSE	Building Products - Home Builders
MTH	NYSE	Building Products - Home Builders
PHM	NYSE	Building Products - Home Builders
TMHC	NYSE	Building Products - Home Builders
TOL	NYSE	Building Products - Home Builders
TPH	NYSE	Building Products - Home Builders
ROL	NYSE	Building Products - Maintenance Service
AWI	NYSE	Building Products - Miscellaneous
BLD	NYSE	Building Products - Miscellaneous
HW	NYSE	Building Products - Miscellaneous
MAS	NYSE	Building Products - Miscellaneous
NCS	NYSE	Building Products - Miscellaneous
OC	NYSE	Building Products - Miscellaneous
URI	NYSE	Building Products - Miscellaneous
THO	NYSE	Building Products - Mobile Homes and RV Builders
WGO	NYSE	Building Products - Mobile Homes and RV Builders
BECN	NSDQ	Building Products - Retail
BMCH	NSDQ	Building Products - Retail
FAST	NSDQ	Building Products - Retail
HD	NYSE	Building Products - Retail
LOW	NYSE	Building Products - Retail
TTS	NSDQ	Building Products - Retail
BCC	NYSE	Building Products - Wood
LPX	NYSE	Building Products - Wood
PCH	NSDQ	Building Products - Wood
RYN	NYSE	Building Products - Wood
WY	NYSE	Building Products - Wood
INFO	NSDQ	Business - Information Services
NLSN	NYSE	Business - Information Services
SPGI	NYSE	Business - Information Services
TRU	NYSE	Business - Information Services
VRSK	NSDQ	Business - Information Services
KNL	NYSE	Business - Office Products
MLHR	NSDQ	Business - Office Products
FDC	NYSE	Business - Services
HCSG	NSDQ	Business - Services
RPXC	NSDQ	Business - Services
CTSH	NSDQ	Business - Software Services
GWRE	NYSE	Business - Software Services
MSCI	NYSE	Business - Software Services
RP	NSDQ	Business - Software Services
CMCSA	NSDQ	Cable Television
DISH	NSDQ	Cable Television
LBRDK	NSDQ	Cable Television
LBTYA	NSDQ	Cable Television
RCI	NYSE	Cable Television
SJR	NYSE	Cable Television
ALB	NYSE	Chemical - Diversified
APD	NYSE	Chemical - Diversified
CC	NYSE	Chemical - Diversified
CE	NYSE	Chemical - Diversified
DD	NYSE	Chemical - Diversified
DOW	NYSE	Chemical - Diversified
EMN	NYSE	Chemical - Diversified
FMC	NYSE	Chemical - Diversified
HUN	NYSE	Chemical - Diversified
KRO	NYSE	Chemical - Diversified
LYB	NYSE	Chemical - Diversified
MEOH	NSDQ	Chemical - Diversified
OLN	NYSE	Chemical - Diversified
PPG	NYSE	Chemical - Diversified
PX	NYSE	Chemical - Diversified
UNVR	NYSE	Chemical - Diversified
POL	NYSE	Chemical - Plastic
RYAM	NYSE	Chemical - Plastic
TSE	NYSE	Chemical - Plastic
WLK	NYSE	Chemical - Plastic
ASH	NYSE	Chemical - Specialty
AXTA	NYSE	Chemical - Specialty
ECL	NYSE	Chemical - Specialty
FOE	NYSE	Chemical - Specialty
GPRE	NSDQ	Chemical - Specialty
IFF	NYSE	Chemical - Specialty
KRA	NYSE	Chemical - Specialty
PAH	NYSE	Chemical - Specialty
SXC	NYSE	Coal
ACIA	NSDQ	Communication - Components
ANET	NYSE	Communication - Components
ARRS	NSDQ	Communication - Components
GIMO	NYSE	Communication - Components
GLW	NYSE	Communication - Components
VIAV	NSDQ	Communication - Components
ADTN	NSDQ	Communication - Infrastructure
COMM	NSDQ	Communication - Infrastructure
LVLT	NYSE	Communication - Infrastructure
ZAYO	NYSE	Communication - Infrastructure
BSFT	NSDQ	Communication - Network Software
DBD	NYSE	Computer - Integrated Systems
FTNT	NSDQ	Computer - Integrated Systems
NCR	NYSE	Computer - Integrated Systems
AAPL	NSDQ	Computer - Mini computers
DDD	NYSE	Computer - Mini computers
BRCD	NSDQ	Computer - Networking
CSCO	NSDQ	Computer - Networking
EXTR	NSDQ	Computer - Networking
INFN	NSDQ	Computer - Networking
NTCT	NSDQ	Computer - Networking
LOGI	NSDQ	Computer - Peripheral Equipment
MRCY	NSDQ	Computer - Peripheral Equipment
CARB	NSDQ	Computer - Services
LOGM	NSDQ	Computer - Services
ACXM	NSDQ	Computers - IT Services
BZUN	NSDQ	Computers - IT Services
CDK	NSDQ	Computers - IT Services
CSRA	NYSE	Computers - IT Services
CYBR	NSDQ	Computers - IT Services
DOX	NSDQ	Computers - IT Services
DXC	NYSE	Computers - IT Services
INFY	NYSE	Computers - IT Services
INOV	NSDQ	Computers - IT Services
SAIC	NYSE	Computers - IT Services
ACIW	NSDQ	Computer - Software
ADBE	NSDQ	Computer - Software
CA	NSDQ	Computer - Software
CDNS	NSDQ	Computer - Software
CHKP	NSDQ	Computer - Software
CTXS	NSDQ	Computer - Software
EPAY	NSDQ	Computer - Software
MANH	NSDQ	Computer - Software
MSFT	NSDQ	Computer - Software
NUAN	NSDQ	Computer - Software
ORCL	NYSE	Computer - Software
OTEX	NSDQ	Computer - Software
PRGS	NSDQ	Computer - Software
PTC	NSDQ	Computer - Software
RHT	NYSE	Computer - Software
SAP	NYSE	Computer - Software
SNPS	NSDQ	Computer - Software
SSNC	NSDQ	Computer - Software
VMW	NYSE	Computer - Software
NTAP	NSDQ	Computer- Storage Devices
SMCI	NSDQ	Computer- Storage Devices
STX	NSDQ	Computer- Storage Devices
TDC	NYSE	Computer- Storage Devices
WDC	NSDQ	Computer- Storage Devices
ACN	NYSE	Consulting Services
CLGX	NYSE	Consulting Services
NTRI	NSDQ	Consumer Products - Discretionary
PRTY	NYSE	Consumer Products - Discretionary
BUFF	NSDQ	Consumer Products - Staples
ENR	NYSE	Consumer Products - Staples
KMB	NYSE	Consumer Products - Staples
NWL	NYSE	Consumer Products - Staples
OLLI	NSDQ	Consumer Products - Staples
SPB	NYSE	Consumer Products - Staples
TUP	NYSE	Consumer Products - Staples
CCK	NYSE	Containers - Metal and Glass
ATR	NYSE	Containers - Paper and Packaging
GPK	NYSE	Containers - Paper and Packaging
PKG	NYSE	Containers - Paper and Packaging
SON	NYSE	Containers - Paper and Packaging
COTY	NYSE	Cosmetics
EL	NYSE	Cosmetics
NUS	NYSE	Cosmetics
TEF	NYSE	Diversified Communication Services
VIV	NYSE	Diversified Communication Services
CSL	NYSE	Diversified Operations
DHR	NYSE	Diversified Operations
GE	NYSE	Diversified Operations
HON	NYSE	Diversified Operations
ITT	NYSE	Diversified Operations
LUK	NYSE	Diversified Operations
MMM	NYSE	Diversified Operations
UTX	NYSE	Diversified Operations
NYLD	NYSE	Electric Construction
APH	NYSE	Electronics - Connectors
BRKS	NSDQ	Electronics - Manufacturing Machinery
ENTG	NSDQ	Electronics - Manufacturing Machinery
KLIC	NSDQ	Electronics - Manufacturing Machinery
MKSI	NSDQ	Electronics - Manufacturing Machinery
UCTT	NSDQ	Electronics - Manufacturing Machinery
CLS	NYSE	Electronics - Manufacturing Services
JBL	NYSE	Electronics - Manufacturing Services
KEYS	NYSE	Electronics - Measuring Instruments
ORBK	NSDQ	Electronics - Measuring Instruments
FLIR	NSDQ	Electronics - Military
LLL	NYSE	Electronics - Military
BWXT	NYSE	Electronics - Miscellaneous Components
CAMP	NSDQ	Electronics - Miscellaneous Components
KEM	NYSE	Electronics - Miscellaneous Components
MBLY	NYSE	Electronics - Miscellaneous Components
TEL	NYSE	Electronics - Miscellaneous Components
TTMI	NSDQ	Electronics - Miscellaneous Components
GRMN	NSDQ	Electronics - Miscellaneous Products
PHG	NYSE	Electronics - Miscellaneous Products
TRMB	NSDQ	Electronics - Miscellaneous Products
ARW	NYSE	Electronics - Parts Distribution
WCC	NYSE	Electronics - Parts Distribution
GNRC	NYSE	Electronics - Power Generation
AAOI	NSDQ	Electronics - Semiconductors
AMBA	NSDQ	Electronics - Semiconductors
AMKR	NSDQ	Electronics - Semiconductors
AVGO	NSDQ	Electronics - Semiconductors
CAVM	NSDQ	Electronics - Semiconductors
CRUS	NSDQ	Electronics - Semiconductors
EXAR	NYSE	Electronics - Semiconductors
FORM	NSDQ	Electronics - Semiconductors
HIMX	NSDQ	Electronics - Semiconductors
IDTI	NSDQ	Electronics - Semiconductors
LSCC	NSDQ	Electronics - Semiconductors
SIMO	NSDQ	Electronics - Semiconductors
SYNA	NSDQ	Electronics - Semiconductors
AME	NYSE	Electronics - Testing Equipment
A	NYSE	Electronics - Testing Equipment
CGNX	NSDQ	Electronics - Testing Equipment
FTV	NYSE	Electronics - Testing Equipment
NATI	NSDQ	Electronics - Testing Equipment
TER	NYSE	Electronics - Testing Equipment
WPZ	NYSE	Energy and Pipeline - Master Limited Partnerships
ACM	NYSE	Engineering - R and D Services
FLR	NYSE	Engineering - R and D Services
JEC	NYSE	Engineering - R and D Services
KBR	NYSE	Engineering - R and D Services
PWR	NYSE	Engineering - R and D Services
AGU	NYSE	Fertilizers
CF	NYSE	Fertilizers
MOS	NYSE	Fertilizers
POT	NYSE	Fertilizers
SQM	NYSE	Fertilizers
CIEN	NYSE	Fiber Optics
FNSR	NSDQ	Fiber Optics
EROS	NYSE	Film and Television Production and Distribution
FOXA	NSDQ	Film and Television Production and Distribution
LGF.A	NYSE	Film and Television Production and Distribution
NWSA	NSDQ	Film and Television Production and Distribution
ALLY	NYSE	Financial - Consumer Loans
COF	NYSE	Financial - Consumer Loans
DFS	NYSE	Financial - Consumer Loans
NAVI	NSDQ	Financial - Consumer Loans
SC	NYSE	Financial - Consumer Loans
SLM	NSDQ	Financial - Consumer Loans
AMTD	NSDQ	Financial - Investment Bank
BGCP	NSDQ	Financial - Investment Bank
ETFC	NSDQ	Financial - Investment Bank
EVR	NYSE	Financial - Investment Bank
GHL	NYSE	Financial - Investment Bank
GS	NYSE	Financial - Investment Bank
LPLA	NSDQ	Financial - Investment Bank
MC	NYSE	Financial - Investment Bank
MS	NYSE	Financial - Investment Bank
RJF	NYSE	Financial - Investment Bank
SCHW	NYSE	Financial - Investment Bank
SF	NYSE	Financial - Investment Bank
WETF	NSDQ	Financial - Investment Bank
AB	NYSE	Financial - Investment Management
AMG	NYSE	Financial - Investment Management
AMP	NYSE	Financial - Investment Management
APAM	NYSE	Financial - Investment Management
APO	NYSE	Financial - Investment Management
BEN	NYSE	Financial - Investment Management
BLK	NYSE	Financial - Investment Management
BX	NYSE	Financial - Investment Management
CG	NSDQ	Financial - Investment Management
FIG	NYSE	Financial - Investment Management
FII	NYSE	Financial - Investment Management
IVZ	NYSE	Financial - Investment Management
JNS	NYSE	Financial - Investment Management
KKR	NYSE	Financial - Investment Management
LAZ	NYSE	Financial - Investment Management
LM	NYSE	Financial - Investment Management
PFG	NYSE	Financial - Investment Management
PSEC	NSDQ	Financial - Investment Management
SEIC	NSDQ	Financial - Investment Management
TROW	NSDQ	Financial - Investment Management
WDR	NYSE	Financial - Investment Management
AER	NYSE	Financial - Leasing Companies
AXP	NYSE	Financial - Miscellaneous Services
CIT	NYSE	Financial - Miscellaneous Services
EEFT	NSDQ	Financial - Miscellaneous Services
HAWK	NSDQ	Financial - Miscellaneous Services
VIRT	NSDQ	Financial - Miscellaneous Services
ESNT	NYSE	Financial - Mortgage & Related Services
NSM	NYSE	Financial - Mortgage & Related Services
CFFN	NSDQ	Financial - Savings and Loan
CFG	NYSE	Financial - Savings and Loan
EVER	NYSE	Financial - Savings and Loan
ISBC	NSDQ	Financial - Savings and Loan
LTXB	NSDQ	Financial - Savings and Loan
PBCT	NSDQ	Financial - Savings and Loan
PPBI	NSDQ	Financial - Savings and Loan
ARCC	NSDQ	Financial - SBIC & Commercial Industry
FSIC	NYSE	Financial - SBIC & Commercial Industry
HTGC	NYSE	Financial - SBIC & Commercial Industry
NMFC	NYSE	Financial - SBIC & Commercial Industry
TCPC	NSDQ	Financial - SBIC & Commercial Industry
ADS	NYSE	Financial Transaction Services
CATM	NSDQ	Financial Transaction Services
EFX	NYSE	Financial Transaction Services
FIS	NYSE	Financial Transaction Services
FISV	NSDQ	Financial Transaction Services
FLT	NYSE	Financial Transaction Services
MA	NYSE	Financial Transaction Services
PAY	NYSE	Financial Transaction Services
QIWI	NSDQ	Financial Transaction Services
TSS	NYSE	Financial Transaction Services
VNTV	NYSE	Financial Transaction Services
V	NYSE	Financial Transaction Services
WU	NYSE	Financial Transaction Services
HSY	NYSE	Food - Confectionery
TWNK	NSDQ	Food - Confectionery
DF	NYSE	Food - Dairy Products
HRL	NYSE	Food - Meat Products
PPC	NSDQ	Food - Meat Products
SAFM	NSDQ	Food - Meat Products
TSN	NYSE	Food - Meat Products
ARMK	NYSE	Food - Miscellaneous
BETR	NYSE	Food - Miscellaneous
CAG	NYSE	Food - Miscellaneous
CPB	NYSE	Food - Miscellaneous
DAR	NYSE	Food - Miscellaneous
GIS	NYSE	Food - Miscellaneous
INGR	NYSE	Food - Miscellaneous
KHC	NSDQ	Food - Miscellaneous
K	NYSE	Food - Miscellaneous
MDLZ	NSDQ	Food - Miscellaneous
MKC	NYSE	Food - Miscellaneous
NOMD	NYSE	Food - Miscellaneous
PF	NYSE	Food - Miscellaneous
POST	NYSE	Food - Miscellaneous
SJM	NYSE	Food - Miscellaneous
SYY	NYSE	Food - Miscellaneous
THS	NYSE	Food - Miscellaneous
USFD	NYSE	Food - Miscellaneous
PFGC	NYSE	Food - Natural Foods Products
SFM	NSDQ	Food - Natural Foods Products
SCI	NYSE	Funeral Services
LEG	NYSE	Furniture
LZB	NYSE	Furniture
SCSS	NSDQ	Furniture
BYD	NYSE	Gaming
IGT	NYSE	Gaming
LVS	NYSE	Gaming
MGM	NYSE	Gaming
MLCO	NSDQ	Gaming
WYNN	NSDQ	Gaming
APOG	NSDQ	Glass Products
OI	NYSE	Glass Products
BAH	NYSE	Government Services
MMS	NYSE	Government Services
BEL	NYSE	Hotels and Motels
HLT	NYSE	Hotels and Motels
H	NYSE	Hotels and Motels
LQ	NYSE	Hotels and Motels
MAR	NSDQ	Hotels and Motels
SNOW	NYSE	Hotels and Motels
STAY	NYSE	Hotels and Motels
WYN	NYSE	Hotels and Motels
WHR	NYSE	Household Appliances
HOLI	NSDQ	Industrial Automation and Robotics
IRBT	NSDQ	Industrial Automation and Robotics
ROK	NYSE	Industrial Automation and Robotics
HDS	NSDQ	Industrial Services
HSC	NYSE	Industrial Services
MSM	NYSE	Industrial Services
SITE	NYSE	Industrial Services
ST	NYSE	Instruments - Control
BRKR	NSDQ	Instruments - Scientific
PKI	NYSE	Instruments - Scientific
WAT	NYSE	Instruments - Scientific
AFL	NYSE	Insurance - Accident and Health
UNM	NYSE	Insurance - Accident and Health
AJG	NYSE	Insurance - Brokerage
BRO	NYSE	Insurance - Brokerage
MMC	NYSE	Insurance - Brokerage
AEL	NYSE	Insurance - Life Insurance
FGL	NYSE	Insurance - Life Insurance
ING	NYSE	Insurance - Life Insurance
LNC	NYSE	Insurance - Life Insurance
MFC	NYSE	Insurance - Life Insurance
PRI	NYSE	Insurance - Life Insurance
SLF	NYSE	Insurance - Life Insurance
TMK	NYSE	Insurance - Life Insurance
VOYA	NYSE	Insurance - Life Insurance
AEG	NYSE	Insurance - Multi line
AIG	NYSE	Insurance - Multi line
AIZ	NYSE	Insurance - Multi line
CI	NYSE	Insurance - Multi line
CNO	NYSE	Insurance - Multi line
HIG	NYSE	Insurance - Multi line
L	NYSE	Insurance - Multi line
MTG	NYSE	Insurance - Multi line
ORI	NYSE	Insurance - Multi line
PRU	NYSE	Insurance - Multi line
ALL	NYSE	Insurance - Property and Casualty
AWH	NYSE	Insurance - Property and Casualty
AXS	NYSE	Insurance - Property and Casualty
CB	NYSE	Insurance - Property and Casualty
CINF	NSDQ	Insurance - Property and Casualty
FAF	NYSE	Insurance - Property and Casualty
FNF	NYSE	Insurance - Property and Casualty
NMIH	NSDQ	Insurance - Property and Casualty
PGR	NYSE	Insurance - Property and Casualty
SIGI	NSDQ	Insurance - Property and Casualty
TPRE	NYSE	Insurance - Property and Casualty
TRV	NYSE	Insurance - Property and Casualty
XL	NYSE	Insurance - Property and Casualty
AMZN	NSDQ	Internet - Commerce
BABA	NYSE	Internet - Commerce
EBAY	NSDQ	Internet - Commerce
EXPE	NSDQ	Internet - Commerce
IAC	NSDQ	Internet - Commerce
LVNTA	NSDQ	Internet - Commerce
MELI	NSDQ	Internet - Commerce
PCLN	NSDQ	Internet - Commerce
STMP	NSDQ	Internet - Commerce
RATE	NYSE	Internet - Content
SFLY	NSDQ	Internet - Content
SINA	NSDQ	Internet - Content
SSTK	NYSE	Internet - Content
WBMD	NSDQ	Internet - Content
WB	NSDQ	Internet - Content
YY	NSDQ	Internet - Content
BITA	NYSE	Internet - Delivery Services
GDDY	NYSE	Internet - Delivery Services
GRUB	NYSE	Internet - Delivery Services
SALE	NSDQ	Internet - Delivery Services
VIPS	NYSE	Internet - Delivery Services
AKAM	NSDQ	Internet - Services
ATHM	NYSE	Internet - Services
BCOR	NSDQ	Internet - Services
BIDU	NSDQ	Internet - Services
FB	NSDQ	Internet - Services
GOOGL	NSDQ	Internet - Services
INXN	NYSE	Internet - Services
TIVO	NSDQ	Internet - Services
YHOO	NSDQ	Internet - Services
ZIXI	NSDQ	Internet - Services
FFIV	NSDQ	Internet - Software
MEET	NSDQ	Internet - Software
PAYC	NYSE	Internet - Software
PYPL	NSDQ	Internet - Software
VEEV	NYSE	Internet - Software
CRTO	NSDQ	Internet - Software and Services
ELLI	NYSE	Internet - Software and Services
MOMO	NSDQ	Internet - Software and Services
NTES	NSDQ	Internet - Software and Services
SABR	NSDQ	Internet - Software and Services
VG	NYSE	Internet - Software and Services
ABBV	NYSE	Large Cap Pharmaceuticals
ABT	NYSE	Large Cap Pharmaceuticals
AZN	NYSE	Large Cap Pharmaceuticals
BMY	NYSE	Large Cap Pharmaceuticals
GSK	NYSE	Large Cap Pharmaceuticals
JNJ	NYSE	Large Cap Pharmaceuticals
LLY	NYSE	Large Cap Pharmaceuticals
MRK	NYSE	Large Cap Pharmaceuticals
NVO	NYSE	Large Cap Pharmaceuticals
NVS	NYSE	Large Cap Pharmaceuticals
PFE	NYSE	Large Cap Pharmaceuticals
SNY	NYSE	Large Cap Pharmaceuticals
LITE	NSDQ	Lasers Systems and Components
BC	NYSE	Leisure and Recreation Products
ELY	NYSE	Leisure and Recreation Products
PII	NYSE	Leisure and Recreation Products
AMC	NYSE	Leisure and Recreation Services
CCL	NYSE	Leisure and Recreation Services
CNK	NYSE	Leisure and Recreation Services
ILG	NSDQ	Leisure and Recreation Services
MYCC	NYSE	Leisure and Recreation Services
NCLH	NSDQ	Leisure and Recreation Services
RCL	NYSE	Leisure and Recreation Services
CAT	NYSE	Manufacturing - Construction and Mining
TEX	NYSE	Manufacturing - Construction and Mining
AOS	NYSE	Manufacturing - Electronics
EMR	NYSE	Manufacturing - Electronics
ETN	NYSE	Manufacturing - Electronics
IIVI	NSDQ	Manufacturing - Electronics
AGCO	NYSE	Manufacturing - Farm Equipment
BGG	NYSE	Manufacturing - Farm Equipment
DE	NYSE	Manufacturing - Farm Equipment
CFX	NYSE	Manufacturing - General Industrial
DOV	NYSE	Manufacturing - General Industrial
FLS	NYSE	Manufacturing - General Industrial
GGG	NYSE	Manufacturing - General Industrial
IEX	NYSE	Manufacturing - General Industrial
IR	NYSE	Manufacturing - General Industrial
ITW	NYSE	Manufacturing - General Industrial
MIDD	NSDQ	Manufacturing - General Industrial
PH	NYSE	Manufacturing - General Industrial
ROP	NYSE	Manufacturing - General Industrial
XYL	NYSE	Manufacturing - General Industrial
PNR	NYSE	Manufacturing - Thermal Products
ATU	NYSE	Manufacturing - Tools & Related Products
KMT	NYSE	Manufacturing - Tools & Related Products
LECO	NSDQ	Manufacturing - Tools & Related Products
SWK	NYSE	Manufacturing - Tools & Related Products
DIS	NYSE	Media Conglomerates
FWONA	NSDQ	Media Conglomerates
TWX	NYSE	Media Conglomerates
VIAB	NSDQ	Media Conglomerates
ALXN	NSDQ	Medical - Biomedical and Genetics
AMAG	NSDQ	Medical - Biomedical and Genetics
AMGN	NSDQ	Medical - Biomedical and Genetics
BIIB	NSDQ	Medical - Biomedical and Genetics
CELG	NSDQ	Medical - Biomedical and Genetics
EXEL	NSDQ	Medical - Biomedical and Genetics
GILD	NSDQ	Medical - Biomedical and Genetics
GLPG	NSDQ	Medical - Biomedical and Genetics
HZNP	NSDQ	Medical - Biomedical and Genetics
IART	NSDQ	Medical - Biomedical and Genetics
ILMN	NSDQ	Medical - Biomedical and Genetics
MYGN	NSDQ	Medical - Biomedical and Genetics
QGEN	NSDQ	Medical - Biomedical and Genetics
REGN	NSDQ	Medical - Biomedical and Genetics
VRTX	NSDQ	Medical - Biomedical and Genetics
ABC	NYSE	Medical - Dental Supplies
ALGN	NSDQ	Medical - Dental Supplies
BCR	NYSE	Medical - Dental Supplies
BDX	NYSE	Medical - Dental Supplies
HSIC	NSDQ	Medical - Dental Supplies
HYH	NYSE	Medical - Dental Supplies
MMSI	NSDQ	Medical - Dental Supplies
PDCO	NSDQ	Medical - Dental Supplies
VWR	NSDQ	Medical - Dental Supplies
WST	NYSE	Medical - Dental Supplies
XRAY	NSDQ	Medical - Dental Supplies
CORT	NSDQ	Medical - Drugs
CTLT	NYSE	Medical - Drugs
ENDP	NSDQ	Medical - Drugs
GRFS	NSDQ	Medical - Drugs
LCI	NYSE	Medical - Drugs
SHPG	NSDQ	Medical - Drugs
UTHR	NSDQ	Medical - Drugs
VRX	NYSE	Medical - Drugs
ZTS	NYSE	Medical - Drugs
AGN	NYSE	Medical - Generic Drugs
MNK	NYSE	Medical - Generic Drugs
MYL	NSDQ	Medical - Generic Drugs
PGNX	NSDQ	Medical - Generic Drugs
SUPN	NSDQ	Medical - Generic Drugs
TEVA	NYSE	Medical - Generic Drugs
AET	NYSE	Medical - HMOs
ANTM	NYSE	Medical - HMOs
CNC	NYSE	Medical - HMOs
HUM	NYSE	Medical - HMOs
MOH	NYSE	Medical - HMOs
SEM	NYSE	Medical - HMOs
UNH	NYSE	Medical - HMOs
WCG	NYSE	Medical - HMOs
ACHC	NSDQ	Medical - Hospital
LPNT	NSDQ	Medical - Hospital
THC	NYSE	Medical - Hospital
UHS	NYSE	Medical - Hospital
CERN	NSDQ	Medical Info Systems
MDRX	NSDQ	Medical Info Systems
MDSO	NSDQ	Medical Info Systems
ANGO	NSDQ	Medical - Instruments
CRHM	AMEX	Medical - Instruments
EW	NYSE	Medical - Instruments
GKOS	NYSE	Medical - Instruments
GMED	NYSE	Medical - Instruments
HOLX	NSDQ	Medical - Instruments
ISRG	NSDQ	Medical - Instruments
MASI	NSDQ	Medical - Instruments
TMO	NYSE	Medical - Instruments
VAR	NYSE	Medical - Instruments
KND	NYSE	Medical - Nursing Homes
DGX	NYSE	Medical - Outpatient and Home Healthcare
DVA	NYSE	Medical - Outpatient and Home Healthcare
EVHC	NYSE	Medical - Outpatient and Home Healthcare
HLS	NYSE	Medical - Outpatient and Home Healthcare
BAX	NYSE	Medical - Products
BSX	NYSE	Medical - Products
HRC	NYSE	Medical - Products
MDT	NYSE	Medical - Products
NUVA	NSDQ	Medical - Products
OSUR	NSDQ	Medical - Products
SYK	NYSE	Medical - Products
VIVO	NSDQ	Medical - Products
ZBH	NYSE	Medical - Products
ABCO	NSDQ	Medical Services
BEAT	NSDQ	Medical Services
CRL	NYSE	Medical Services
ESRX	NSDQ	Medical Services
HQY	NSDQ	Medical Services
ICLR	NSDQ	Medical Services
PRAH	NSDQ	Medical Services
PRXL	NSDQ	Medical Services
Q	NYSE	Medical Services
TVTY	NSDQ	Medical Services
RS	NYSE	Metal Products - Distribution
TKR	NYSE	Metal Products - Procurement and Fabrication
WOR	NYSE	Metal Products - Procurement and Fabrication
ABX	NYSE	Mining - Gold
AEM	NYSE	Mining - Gold
FNV	NYSE	Mining - Gold
GG	NYSE	Mining - Gold
GOLD	NSDQ	Mining - Gold
NEM	NYSE	Mining - Gold
VALE	NYSE	Mining - Iron
DDC	NYSE	Mining - Miscellaneous
HBM	NYSE	Mining - Miscellaneous
SWC	NYSE	Mining - Miscellaneous
TECK	NYSE	Mining - Miscellaneous
ARNC	NYSE	Mining - Non Ferrous
FCX	NYSE	Mining - Non Ferrous
SCCO	NYSE	Mining - Non Ferrous
AG	NYSE	Mining - Silver
HL	NYSE	Mining - Silver
PAAS	NSDQ	Mining - Silver
SLW	NYSE	Mining - Silver
TAHO	NYSE	Mining - Silver
CAJ	NYSE	Office Automation and Equipment
PBI	NYSE	Office Automation and Equipment
ACCO	NYSE	Office Supplies
AVY	NYSE	Office Supplies
ATW	NYSE	Oil and Gas - Drilling
DO	NYSE	Oil and Gas - Drilling
ESV	NYSE	Oil and Gas - Drilling
RDC	NYSE	Oil and Gas - Drilling
RIG	NYSE	Oil and Gas - Drilling
CPG	NYSE	Oil and Gas - Exploration and Production - Canadian
ECA	NYSE	Oil and Gas - Exploration and Production - Canadian
AR	NYSE	Oil and Gas - Exploration and Production - United States
COG	NYSE	Oil and Gas - Exploration and Production - United States
CPE	NYSE	Oil and Gas - Exploration and Production - United States
CXO	NYSE	Oil and Gas - Exploration and Production - United States
DVN	NYSE	Oil and Gas - Exploration and Production - United States
EQT	NYSE	Oil and Gas - Exploration and Production - United States
FANG	NSDQ	Oil and Gas - Exploration and Production - United States
GPOR	NSDQ	Oil and Gas - Exploration and Production - United States
LPI	NYSE	Oil and Gas - Exploration and Production - United States
MTDR	NYSE	Oil and Gas - Exploration and Production - United States
NFX	NYSE	Oil and Gas - Exploration and Production - United States
PE	NYSE	Oil and Gas - Exploration and Production - United States
PXD	NYSE	Oil and Gas - Exploration and Production - United States
RICE	NYSE	Oil and Gas - Exploration and Production - United States
RSPP	NYSE	Oil and Gas - Exploration and Production - United States
SWN	NYSE	Oil and Gas - Exploration and Production - United States
XEC	NYSE	Oil and Gas - Exploration and Production - United States
CLB	NYSE	Oil and Gas - Field Services
FTI	NYSE	Oil and Gas - Field Services
OII	NYSE	Oil and Gas - Field Services
SLB	NYSE	Oil and Gas - Field Services
CVE	NYSE	Oil and Gas - Integrated - Canadian
SU	NYSE	Oil and Gas - Integrated - Canadian
PBR	NYSE	Oil and Gas - Integrated - Emerging Markets
CVX	NYSE	Oil and Gas - Integrated - International
TOT	NYSE	Oil and Gas - Integrated - International
XOM	NYSE	Oil and Gas - Integrated - International
DRQ	NYSE	Oil and Gas - Mechanical and and Equitment
MDR	NYSE	Oil and Gas - Mechanical and and Equitment
AM	NYSE	Oil and Gas - Production and Pipelines
KMI	NYSE	Oil and Gas - Production and Pipelines
MPLX	NYSE	Oil and Gas - Production and Pipelines
PAGP	NYSE	Oil and Gas - Production and Pipelines
PBA	NYSE	Oil and Gas - Production and Pipelines
TRP	NYSE	Oil and Gas - Production and Pipelines
UGP	NYSE	Oil and Gas - Production and Pipelines
WMB	NYSE	Oil and Gas - Production and Pipelines
BPL	NYSE	Oil and Gas - Production Pipeline - MLB
BWP	NYSE	Oil and Gas - Production Pipeline - MLB
EEP	NYSE	Oil and Gas - Production Pipeline - MLB
EPD	NYSE	Oil and Gas - Production Pipeline - MLB
ETE	NYSE	Oil and Gas - Production Pipeline - MLB
ETP	NYSE	Oil and Gas - Production Pipeline - MLB
MMP	NYSE	Oil and Gas - Production Pipeline - MLB
NS	NYSE	Oil and Gas - Production Pipeline - MLB
OKS	NYSE	Oil and Gas - Production Pipeline - MLB
PAA	NYSE	Oil and Gas - Production Pipeline - MLB
SEP	NYSE	Oil and Gas - Production Pipeline - MLB
HFC	NYSE	Oil and Gas - Refining and Marketing
MPC	NYSE	Oil and Gas - Refining and Marketing
PSX	NYSE	Oil and Gas - Refining and Marketing
TSO	NYSE	Oil and Gas - Refining and Marketing
VLO	NYSE	Oil and Gas - Refining and Marketing
WNR	NYSE	Oil and Gas - Refining and Marketing
CVRR	NYSE	Oil and Gas - Refining and Marketing - Master Limited Partnerships
SUN	NYSE	Oil and Gas - Refining and Marketing - Master Limited Partnerships
ADP	NSDQ	Outsourcing
BCO	NYSE	Outsourcing
BR	NYSE	Outsourcing
CVG	NYSE	Outsourcing
G	NYSE	Outsourcing
PAYX	NSDQ	Outsourcing
RPM	NYSE	Paints and Related Products
SHW	NYSE	Paints and Related Products
FBR	NYSE	Paper and Related Products
IP	NYSE	Paper and Related Products
KS	NYSE	Paper and Related Products
UFS	NYSE	Paper and Related Products
WRK	NYSE	Paper and Related Products
DCI	NYSE	Pollution Control
ERII	NSDQ	Pollution Control
GCI	NYSE	Publishing - Newspapers
NYT	NYSE	Publishing - Newspapers
MDP	NYSE	Publishing - Periodicals
FOR	NYSE	Real Estate - Development
LGIH	NSDQ	Real Estate - Development
CBG	NYSE	Real Estate - Operations
PMT	NYSE	Real Estate - Operations
RLGY	NYSE	Real Estate - Operations
AGNC	NSDQ	REIT and Equity Trust
ARI	NYSE	REIT and Equity Trust
ASPS	NSDQ	REIT and Equity Trust
BXMT	NYSE	REIT and Equity Trust
CLNS	NYSE	REIT and Equity Trust
CYS	NYSE	REIT and Equity Trust
HASI	NYSE	REIT and Equity Trust
MTGE	NSDQ	REIT and Equity Trust
NRZ	NYSE	REIT and Equity Trust
NYMT	NSDQ	REIT and Equity Trust
STWD	NYSE	REIT and Equity Trust
TWO	NYSE	REIT and Equity Trust
AMT	NYSE	REIT and Equity Trust - Other
ARE	NYSE	REIT and Equity Trust - Other
BDN	NYSE	REIT and Equity Trust - Other
BXP	NYSE	REIT and Equity Trust - Other
CCI	NYSE	REIT and Equity Trust - Other
CHSP	NYSE	REIT and Equity Trust - Other
CLI	NYSE	REIT and Equity Trust - Other
CONE	NSDQ	REIT and Equity Trust - Other
CTRE	NSDQ	REIT and Equity Trust - Other
CUBE	NYSE	REIT and Equity Trust - Other
CUZ	NYSE	REIT and Equity Trust - Other
CXW	NYSE	REIT and Equity Trust - Other
DCT	NYSE	REIT and Equity Trust - Other
DEI	NYSE	REIT and Equity Trust - Other
DFT	NYSE	REIT and Equity Trust - Other
DLR	NYSE	REIT and Equity Trust - Other
DOC	NYSE	REIT and Equity Trust - Other
DRH	NYSE	REIT and Equity Trust - Other
EQC	NYSE	REIT and Equity Trust - Other
ESRT	NYSE	REIT and Equity Trust - Other
EXR	NYSE	REIT and Equity Trust - Other
FR	NYSE	REIT and Equity Trust - Other
FSP	AMEX	REIT and Equity Trust - Other
GEO	NYSE	REIT and Equity Trust - Other
GLPI	NSDQ	REIT and Equity Trust - Other
GNL	NYSE	REIT and Equity Trust - Other
GOOD	NSDQ	REIT and Equity Trust - Other
GOV	NSDQ	REIT and Equity Trust - Other
GPT	NYSE	REIT and Equity Trust - Other
HCP	NYSE	REIT and Equity Trust - Other
HIW	NYSE	REIT and Equity Trust - Other
HPP	NYSE	REIT and Equity Trust - Other
HPT	NSDQ	REIT and Equity Trust - Other
HST	NYSE	REIT and Equity Trust - Other
HTA	NYSE	REIT and Equity Trust - Other
HT	NYSE	REIT and Equity Trust - Other
IRM	NYSE	REIT and Equity Trust - Other
KRC	NYSE	REIT and Equity Trust - Other
LAMR	NSDQ	REIT and Equity Trust - Other
LPT	NYSE	REIT and Equity Trust - Other
MGP	NYSE	REIT and Equity Trust - Other
MPW	NYSE	REIT and Equity Trust - Other
NSA	NYSE	REIT and Equity Trust - Other
OHI	NYSE	REIT and Equity Trust - Other
OUT	NYSE	REIT and Equity Trust - Other
PDM	NYSE	REIT and Equity Trust - Other
PEB	NYSE	REIT and Equity Trust - Other
PLD	NYSE	REIT and Equity Trust - Other
PSA	NYSE	REIT and Equity Trust - Other
QTS	NYSE	REIT and Equity Trust - Other
REXR	NYSE	REIT and Equity Trust - Other
RLJ	NYSE	REIT and Equity Trust - Other
SBRA	NSDQ	REIT and Equity Trust - Other
SHO	NYSE	REIT and Equity Trust - Other
SLG	NYSE	REIT and Equity Trust - Other
SNH	NSDQ	REIT and Equity Trust - Other
STAG	NYSE	REIT and Equity Trust - Other
VNO	NYSE	REIT and Equity Trust - Other
VTR	NYSE	REIT and Equity Trust - Other
WRE	NYSE	REIT and Equity Trust - Other
WSR	NYSE	REIT and Equity Trust - Other
ACC	NYSE	REIT and Equity Trust - Residential
AVB	NYSE	REIT and Equity Trust - Residential
CPT	NYSE	REIT and Equity Trust - Residential
EDR	NYSE	REIT and Equity Trust - Residential
EQR	NYSE	REIT and Equity Trust - Residential
ESS	NYSE	REIT and Equity Trust - Residential
MAA	NYSE	REIT and Equity Trust - Residential
MORE	NYSE	REIT and Equity Trust - Residential
SIR	NSDQ	REIT and Equity Trust - Residential
SRC	NYSE	REIT and Equity Trust - Residential
UDR	NYSE	REIT and Equity Trust - Residential
AKR	NYSE	REIT and Equity Trust - Retail
DDR	NYSE	REIT and Equity Trust - Retail
EPR	NYSE	REIT and Equity Trust - Retail
EQIX	NSDQ	REIT and Equity Trust - Retail
FRT	NYSE	REIT and Equity Trust - Retail
MAC	NYSE	REIT and Equity Trust - Retail
NNN	NYSE	REIT and Equity Trust - Retail
O	NYSE	REIT and Equity Trust - Retail
REG	NYSE	REIT and Equity Trust - Retail
ROIC	NSDQ	REIT and Equity Trust - Retail
RPT	NYSE	REIT and Equity Trust - Retail
SKT	NYSE	REIT and Equity Trust - Retail
SPG	NYSE	REIT and Equity Trust - Retail
STOR	NYSE	REIT and Equity Trust - Retail
WPG	NYSE	REIT and Equity Trust - Retail
WRI	NYSE	REIT and Equity Trust - Retail
CHS	NYSE	Retail - Apparel and Shoes
FL	NYSE	Retail - Apparel and Shoes
GCO	NYSE	Retail - Apparel and Shoes
GPS	NYSE	Retail - Apparel and Shoes
PLCE	NSDQ	Retail - Apparel and Shoes
AAN	NYSE	Retail - Consumer Electronics
BBY	NYSE	Retail - Consumer Electronics
BIG	NYSE	Retail - Discount Stores
COST	NSDQ	Retail - Discount Stores
DLTR	NSDQ	Retail - Discount Stores
TJX	NYSE	Retail - Discount Stores
PIR	NYSE	Retail - Home Furnishings
RH	NYSE	Retail - Home Furnishings
TPX	NYSE	Retail - Home Furnishings
WSM	NYSE	Retail - Home Furnishings
TIF	NYSE	Retail - Jewelry
HSNI	NSDQ	Retail - Mail Order
NLS	NYSE	Retail - Mail Order
BBBY	NSDQ	Retail - Miscellaneous
BGFV	NSDQ	Retail - Miscellaneous
BKS	NYSE	Retail - Miscellaneous
CAB	NYSE	Retail - Miscellaneous
DKS	NYSE	Retail - Miscellaneous
FIVE	NSDQ	Retail - Miscellaneous
ULTA	NSDQ	Retail - Miscellaneous
CVS	NYSE	Retail - Pharmacies and Drug Stores
DPLO	NYSE	Retail - Pharmacies and Drug Stores
GNC	NYSE	Retail - Pharmacies and Drug Stores
HLF	NYSE	Retail - Pharmacies and Drug Stores
WBA	NSDQ	Retail - Pharmacies and Drug Stores
JCP	NYSE	Retail - Regional Department Stores
BJRI	NSDQ	Retail - Restaurants
BLMN	NSDQ	Retail - Restaurants
BWLD	NSDQ	Retail - Restaurants
CAKE	NSDQ	Retail - Restaurants
CMG	NYSE	Retail - Restaurants
DRI	NYSE	Retail - Restaurants
FRGI	NSDQ	Retail - Restaurants
PLAY	NSDQ	Retail - Restaurants
PNRA	NSDQ	Retail - Restaurants
PZZA	NSDQ	Retail - Restaurants
QSR	NYSE	Retail - Restaurants
SBUX	NSDQ	Retail - Restaurants
SHAK	NYSE	Retail - Restaurants
TXRH	NSDQ	Retail - Restaurants
CBD	NYSE	Retail - Supermarkets
WMT	NYSE	Retail - Supermarkets
GT	NSDQ	Rubber - Tires
DGI	NYSE	Satellite and Communication
IRDM	NSDQ	Satellite and Communication
DV	NYSE	Schools
EDU	NYSE	Schools
LOPE	NSDQ	Schools
NORD	NYSE	Schools
TAL	NYSE	Schools
CBOE	NSDQ	Securities and Exchanges
CME	NSDQ	Securities and Exchanges
ICE	NYSE	Securities and Exchanges
NDAQ	NSDQ	Securities and Exchanges
ALLE	NYSE	Security and Safety Services
FBHS	NYSE	Security and Safety Services
JCI	NYSE	Security and Safety Services
ADI	NSDQ	Semiconductor - Analog and Mixed
IPHI	NYSE	Semiconductor - Analog and Mixed
MCHP	NSDQ	Semiconductor - Analog and Mixed
MSCC	NSDQ	Semiconductor - Analog and Mixed
MTSI	NSDQ	Semiconductor - Analog and Mixed
MXIM	NSDQ	Semiconductor - Analog and Mixed
MXL	NYSE	Semiconductor - Analog and Mixed
NXPI	NSDQ	Semiconductor - Analog and Mixed
ON	NSDQ	Semiconductor - Analog and Mixed
TSM	NYSE	Semiconductor - Circuit Foundry
CY	NSDQ	Semiconductor - Communications
MRVL	NSDQ	Semiconductor - Communications
NPTN	NYSE	Semiconductor - Communications
VSH	NYSE	Semiconductor - Discretes
PLAB	NSDQ	Semiconductor Equipment - Photomasks
AEIS	NSDQ	Semiconductor Equipment - Wafer Fabrication
AMAT	NSDQ	Semiconductor Equipment - Wafer Fabrication
ASML	NSDQ	Semiconductor Equipment - Wafer Fabrication
KLAC	NSDQ	Semiconductor Equipment - Wafer Fabrication
LRCX	NSDQ	Semiconductor Equipment - Wafer Fabrication
INTC	NSDQ	Semiconductor - General
STM	NYSE	Semiconductor - General
TXN	NSDQ	Semiconductor - General
XCRA	NSDQ	Semiconductor - General
MU	NSDQ	Semiconductor Memory
XLNX	NSDQ	Semiconductors - Programmable Logic
SWKS	NSDQ	Semiconductors - Radio Frequency
CRI	NYSE	Shoes and Retail Apparel
DECK	NYSE	Shoes and Retail Apparel
FRAN	NSDQ	Shoes and Retail Apparel
ICON	NSDQ	Shoes and Retail Apparel
NKE	NYSE	Shoes and Retail Apparel
SHOO	NSDQ	Shoes and Retail Apparel
SKX	NYSE	Shoes and Retail Apparel
WWW	NYSE	Shoes and Retail Apparel
CHD	NYSE	Soap and Cleaning Materials
CL	NYSE	Soap and Cleaning Materials
CLX	NYSE	Soap and Cleaning Materials
PG	NYSE	Soap and Cleaning Materials
KFY	NYSE	Staffing Firms
MAN	NYSE	Staffing Firms
RHI	NYSE	Staffing Firms
TBI	NYSE	Staffing Firms
MWA	NYSE	Steel - Pipe and Tube
TS	NYSE	Steel - Pipe and Tube
CMC	NYSE	Steel - Producers
MT	NYSE	Steel - Producers
NUE	NYSE	Steel - Producers
PKX	NYSE	Steel - Producers
SCHN	NSDQ	Steel - Producers
STLD	NSDQ	Steel - Producers
TX	NYSE	Steel - Producers
TRI	NYSE	Technology Services
COH	NYSE	Textile - Apparel
GIL	NYSE	Textile - Apparel
HBI	NYSE	Textile - Apparel
LULU	NSDQ	Textile - Apparel
PVH	NYSE	Textile - Apparel
UAA	NYSE	Textile - Apparel
MHK	NYSE	Textile - Home Furnishing
TILE	NSDQ	Textile - Home Furnishing
MO	NYSE	Tobacco
SNA	NYSE	Tools - Handheld
TTC	NYSE	Tools - Handheld
ATVI	NSDQ	Toys - Games - Hobbies
EA	NSDQ	Toys - Games - Hobbies
HAS	NSDQ	Toys - Games - Hobbies
TTWO	NSDQ	Toys - Games - Hobbies
FDX	NYSE	Transportation - Air Freight and Cargo
RLGT	AMEX	Transportation - Air Freight and Cargo
UPS	NYSE	Transportation - Air Freight and Cargo
AAL	NSDQ	Transportation - Airline
ALK	NYSE	Transportation - Airline
DAL	NYSE	Transportation - Airline
HA	NSDQ	Transportation - Airline
JBLU	NSDQ	Transportation - Airline
LFL	NYSE	Transportation - Airline
LUV	NYSE	Transportation - Airline
SAVE	NSDQ	Transportation - Airline
SKYW	NSDQ	Transportation - Airline
UAL	NYSE	Transportation - Airline
AL	NYSE	Transportation - Equipment and Leasing
GBX	NYSE	Transportation - Equipment and Leasing
TRN	NYSE	Transportation - Equipment and Leasing
TRTN	NYSE	Transportation - Equipment and Leasing
WAB	NYSE	Transportation - Equipment and Leasing
CNI	NYSE	Transportation - Rail
CP	NYSE	Transportation - Rail
CSX	NSDQ	Transportation - Rail
GWR	NYSE	Transportation - Rail
KSU	NYSE	Transportation - Rail
NSC	NYSE	Transportation - Rail
UNP	NYSE	Transportation - Rail
CHRW	NSDQ	Transportation - Services
EXPD	NSDQ	Transportation - Services
STB	NSDQ	Transportation - Services
XPO	NYSE	Transportation - Services
ANW	NYSE	Transportation - Shipping
CMRE	NYSE	Transportation - Shipping
EURN	NYSE	Transportation - Shipping
FRO	NYSE	Transportation - Shipping
GLOG	NYSE	Transportation - Shipping
KEX	NYSE	Transportation - Shipping
NAT	NYSE	Transportation - Shipping
SFL	NYSE	Transportation - Shipping
SSW	NYSE	Transportation - Shipping
HTLD	NSDQ	Transportation - Truck
JBHT	NSDQ	Transportation - Truck
ODFL	NSDQ	Transportation - Truck
WERN	NSDQ	Transportation - Truck
CTAS	NSDQ	Uniform and Related
AEP	NYSE	Utility - Electric Power
AES	NYSE	Utility - Electric Power
AGR	NYSE	Utility - Electric Power
BIP	NYSE	Utility - Electric Power
CMS	NYSE	Utility - Electric Power
CNP	NYSE	Utility - Electric Power
D	NYSE	Utility - Electric Power
DTE	NYSE	Utility - Electric Power
ED	NYSE	Utility - Electric Power
EIX	NYSE	Utility - Electric Power
ELP	NYSE	Utility - Electric Power
ETR	NYSE	Utility - Electric Power
EXC	NYSE	Utility - Electric Power
FE	NYSE	Utility - Electric Power
GXP	NYSE	Utility - Electric Power
KEP	NYSE	Utility - Electric Power
LNT	NYSE	Utility - Electric Power
NEE	NYSE	Utility - Electric Power
NI	NYSE	Utility - Electric Power
NRG	NYSE	Utility - Electric Power
NWE	NYSE	Utility - Electric Power
PCG	NYSE	Utility - Electric Power
PEGI	NSDQ	Utility - Electric Power
PEG	NYSE	Utility - Electric Power
PNW	NYSE	Utility - Electric Power
PPL	NYSE	Utility - Electric Power
WR	NYSE	Utility - Electric Power
ATO	NYSE	Utility - Gas Distribution
MDU	NYSE	Utility - Gas Distribution
NFG	NYSE	Utility - Gas Distribution
NJR	NYSE	Utility - Gas Distribution
OKE	NYSE	Utility - Gas Distribution
SJI	NYSE	Utility - Gas Distribution
SRE	NYSE	Utility - Gas Distribution
UGI	NYSE	Utility - Gas Distribution
SBS	NYSE	Utility - Water Supply
RSG	NYSE	Waste Removal Services
SRCL	NSDQ	Waste Removal Services
WCN	NYSE	Waste Removal Services
WM	NYSE	Waste Removal Services
HRS	NYSE	Wireless Equipment
IDCC	NSDQ	Wireless Equipment
JNPR	NYSE	Wireless Equipment
NOK	NYSE	Wireless Equipment
QCOM	NSDQ	Wireless Equipment
UBNT	NSDQ	Wireless Equipment
CTL	NYSE	Wireless National
TMUS	NSDQ	Wireless National
T	NYSE	Wireless National
AMX	NYSE	Wireless Non-US
KT	NYSE	Wireless Non-US
MBT	NYSE	Wireless Non-US
SKM	NYSE	Wireless Non-US
TSU	NYSE	Wireless Non-US
CNSL	NSDQ	Wireline - Regional - Rural
